############################################################################################################
############################################################################################################
############################################################################################################
############################################################################################################
############################################################################################################
############################################################################################################
############################################################################################################
###################################################    #####################################################
###################################################    ####################### ##  #########################
########################################        #####  ########################### #########################
############################################  #######  ######       ##    #    #############################
######################################## #             ##     ####            #######     ##################
########################################    ##     ##     ########## #####                ##################
########################################                  #####         ##  #         ######################
########################################               ###########  #   ##  ################################
######################################## ##   # ####  #############    ###  ################################
########################################        ####  ######################################################
##########################################  ########     ###################################################
###################################################      ###################################################
############################################################################################################
############################################################################################################
############################################################################################################
############################################################################################################
############################################################################################################
############################################################################################################
############################################################################################################
############################################################################################################
############################################################################################################
############################################################################################################
############################################################################################################