############################################################################################################
############################################################################################################
############################################################################################################
###########################################    #############################################################
###########################################    #############################################################
###########################################    #############################################################
###########################################    ############################################################
############################################  #############################################################
############################################  ##############################################################
########################################          #########################################################
###############################     ########  ##############################################################
###############################                   ##     ##             ##    ###############################
###############################     ####          ##     ##                   ##############################
################################# ##############  ##     ##  #########  ##    #############################
###############################     ####      ##  #### ####  #########  ###################################
###############################     ####      ##             ######        ##################################
###############################     ####                     ######        #################################
########################################      #####################        ##################################
########################################      ########################  #####################################
#######################################################   ##########      ##################################
#######################################################                   ##################################
#######################################################   ##########      ##################################
############################################################################################################
############################################################################################################
############################################################################################################
############################################################################################################
############################################################################################################
############################################################################################################
############################################################################################################
############################################################################################################