############################################################################################################
############################################################################################################
############################################################################################################
############################################################################################################
############################################################################################################
############################################################################################################
############################################################################################################
###################################################    #####################################################
###################################################    ####################### ##  #########################
########################################        #####  ########################### #########################
############################################  #######  ######       ##    #    ###########################
######################################## #             ##     ####            #######     ###############
########################################           ##     ################                ######################
########################################                  ################  #         ######################
########################################               ###################  ################################
######################################## ##   # ####  ####################  ################################
########################################        ####  ######################################################
##########################################  ########     ###################################################
###################################################      ###################################################
############################################################################################################
############################################################################################################
############################################################################################################
############################################################################################################
############################################################################################################
############################################################################################################
############################################################################################################
############################################################################################################
############################################################################################################
############################################################################################################
############################################################################################################